 0  0  0  0  0  0  0  0  0  0  0  0  0  0  0  0  0  0  0  0 
 0  0  0  0  0  0  0  0  0  0  0  0  0  0  0  0  0  0  0  0 
 0  0  0  0  0  0  0  0  0  0  0  0  0  0  0  0  0  0  0  0 
 0  0  0  0  0  0  0  0  0  0  0  0  0  0  0  0  0  0  0  0 
 0  0  0  0  0  0  0  0  0  0  0  0  0  0  0  0  0  0  0  0 
 0  0  0  0  0  0  0  0  0  0  0  0  0  0  0  0  0  0  0  0 
 0  0  0  0  0  0  0  0  0 -98 -99  0  0  0  0  0  0  0  0  0 
 0  0  0  0  0  0  0  0  0 -109  0  0  0  0  0  0  0  0  0  0 
-33  0  0  0 -117  0  0  0  0 -120  0  0  0 -76 -77  0  0  0  0  0 
 1  2  2  2 10 10  2 10 10 10  9  9  9 10 11  9 10  9 11  3 
12 22 13 13 20 13 20 21 13 15 13 13 13 20 13 13 15 13 13 14 
